XXXXXXXXXXXXXXXXXXXXXXXXXXXX
XOOOOOOOOOOOOXXOOOOOOOOOOOOX
XOXXXXOXXXXXOXXOXXXXXOXXXXOX
XEXXXXGXXXXXOXXOXXXXXGXXXXEX
XOXXXXOXXXXXOXXOXXXXXOXXXXOX
XOOOOOOOOOOOOOOOOOOOOOOOOOOX
XOXXXXOXXOXXXXXXXXOXXOXXXXOX
XOXXXXOXXOXXXXXXXXOXXOXXXXOX
XOOOOOOXXOOOOXXOOOOXXOOOOOOX
XXXXXXOXXXXXOXXOXXXXXOXXXXXX
XXXXXXOXXXXXOXXOXXXXXOXXXXXX
XXXXXXOXXOOOOOOOOOOXXOXXXXXX
XXXXXXOXXOXXXXXXXXOXXOXXXXXX
XXXXXXOOOOXOOGGOOXOOOOXXXXXX
XXXXXXOXXOXXXTTXXXOXXOXXXXXX
XXXXXXOXXOOOOOOOOOOXXOXXXXXX
XXXXXXOXXOXXXXXXXXOXXOXXXXXX
XXXXXXOXXOXXXXXXXXOXXOXXXXXX
XOOOOOOOOOOOOXXOOOOOOOOOOOOX
XOXXXXOXXXXXOXXOXXXXXOXXXXOX
XOXXXXOXXXXXOXXOXXXXXOXXXXOX
XEOOXXOOOOOOOPPOOOOOOOXXOOEX
XXXOXXOXXOXXXXXXXXOXXOXXOXXX
XXXOXXOXXOXXXXXXXXOXXOXXOXXX
XOOOOOOXXOOOOXXOOOOXXOOOOOOX
XOXXXXXXXXXXOXXOXXXXXXXXXXOX
XOXXXXXXXXXXOXXOXXXXXXXXXXOX
XGOOOOOOOOOOOOOOOOOOOOOOOOGX
XXXXXXXXXXXXXXXXXXXXXXXXXXXX