XXXXXXXXXXXXXXXXXXXXXXXXXXXXXXXXXXX
XXXXXXXXXXXXoGoGoGoGoGoXXXXXXXXXXXX
XXXXXXXXXXXXTXXXXTXXXXTXXXXXXXXXXXX
XSoooooooooooooooooooooooooooooooSX
XoXXXXXXXXXXXXXXXoXXXXXXXXXXXXXXXoX
XoXoooooooooooooooooooooooooooooXoX
XoXoXXXXXXXXXXXXXOXXXXXXXXXXXXXoXoX
XoXoXoooooooooooooooooooooooooXoXoX
XoXoXoXXXXXXXXXXXoXXXXXXXXXXXoXoXoX
XoXoXoXoooooooooooooooooooooXoXoXoX
XoXoXoXoXXXXXXXXXoXXXXXXXXXoXoXoXoX
XoXoXoXoXXXXoooXXoXoXXXXXoXoXoXoXoX
XoXoXoXoXXXXoXoXXoXoooooooXoXoXoXoX
XoXoXoXoXXXXoXoXXoXXXXoXXXXoXoXoXoX
XoXoXoXoXooooooooooooooXXXXoXoXoXoX
XoXoXoXoXoXXoXoXXoXXXXoXXXXoXoXoXoX
XoXoXoXoXooooooXXoXXXXoXXXXoXoXoXoX
XoXoXoXoXXXXoXXXXoXXXXoXXXXoXoXoXoX
XoXoXoXoXXXXoXXXXoXXXXoXXXXoXoXoXoX
XoooOooooooooooooPooooooooooooOoooX
XoXoXoXoXXXXoXXXXoXXXXXXXXXoXoXoXoX
XoXoXoXoXXXoooXXXoXXXXXXXXXoXoXoXoX
XoXoXoXoXXooXooXXoXXXXXXXXXoXoXoXoX
XoXoXoXoXooXXXooXoXXXXXXXXXoXoXoXoX
XoXoXoXoXoXXXXXoooXXXXXXXXXoXoXoXoX
XoXoXoXoXooXXXooXoXXXXXXXXXoXoXoXoX
XoXoXoXoXXooXooXXoXXXXXXXXXoXoXoXoX
XoXoXoXoXXXoooXXXoXXXXXXXXXoXoXoXoX
XoXoXoXoXXXXoXXXXoXXXXXXXXXoXoXoXoX
XoXoXoXoooooooooooooooooooooXoXoXoX
XoXoXoXXXXXXXXXXXoXXXXXXXXXXXoXoXoX
XoXoXoooooooooooooooooooooooooXoXoX
XoXoXXXXXXXXXXXXXOXXXXXXXXXXXXXoXoX
XoXoooooooooooooooooooooooooooooXoX
XoXXXXXXXXXXXXXXXXXXXXXXXXXXXXXXXoX
XSoooooooooooooooooooooooooooooooSX
XXXXXXXXXXXXXXXXXXXXXXXXXXXXXXXXXXX