XXXXXXXXXXXXXXXXXXXXXXXXXXXX
XEXXXXOXXXXXOXXOXXXXXOXXXXEX
XOXXXXOXXXXXOXXOXXXXXOXXXXOX
XOOOOOOOOOOOOPPOOOOOOSSSSSSX
XOXXXXOXXOXXXXXXXXOXXOXXXXOX
XXXXXXOXXXXXOXXOXXXXXOXXXXXX
XXXXXXOXXOOGGGGGGOOXXOXXXXXX