XXXXXXXXXXXXXXXXXXXXXXXXXXXX
XEXXXXOXXXXXOXXOXXXXXOXXXXEX
XOXXXXOXXXXXOXXOXXXXXOXXXXOX
XOOOOOOOOOOOOPPOOOOOOOOOOOOX
XOXXXXOXXOXXXXXXXXOXXOXXXXOX
XXXXXXOXXXXXOXXOXXXXXOXXXXXX
XXXXXXOXXOOGGGGGGOOXXOXXXXXX