XXXXXXXXXXXXXXXXXXXXXXXXXXXXXXXXXXX
XXXXXXXXXXXX_G_G_G_G_G_XXXXXXXXXXXX
XXXXXXXXXXXXTXXXXTXXXXTXXXXXXXXXXXX
XSoooooooooooooooooooooooooooooooSX
XoXXXXXXXoXXXXXXXoXXXXXXXoXXXXXXXoX
XoXoooooooooooooooooooooooooooooXoX
XoXoXXXoXXXXoXXXXOXXXXoXXXXoXXXoXoX
XoXoXoooooooooooooooooooooooooXoXoX
XoXoXoXXXXXXXXXXXoXXXXXXXXXXXoXoXoX
XoooooXoooooooooooooooooooooXoooooX
XoXoXoXoXXXXXXXXXoXXXXXXXXXoXoXoXoX
XoXXXoXoXXXXoooXXoXoXXXXXoXoXoXXXoX
XoXXXoXoXXXXoXoXXoXoooooooXoXoXXXoX
XoXoXoXoXXXXoXoXXoXXXXoXXXXoXoXoXoX
XoooooXoXooooooooooooooXXXXoXoooooX
XoXoXoXoXoXXoXoXX_XXXXoXXXXoXoXoXoX
XoXoXoXoXooooooXX_XXXXoXXXXoXoXoXoX
XoXoXoXoXXXXoXXXX_XXXXoXXXXoXoXoXoX
XoXoXoXoXXXXoXXXX_XXXXoXXXXoXoXoXoX
XoooOoooooooo____P____ooooooooOoooX
XoXXXoXoXXXXoXXXX_XXXXoXXXXoXoXXXoX
XoXoooXoXXXoooXXX_XXXXoXXXXoXoooXoX
XoooXoXoXXooXooXX_XXXXoXXXXoXoXoooX
XoXXXoXoXooXXXooX_XXXXoXXXXoXoXXXoX
XoooooXoXoXXXXXoooooooooooooXoooooX
XoXoXoXoXooXXXooXoXXXXoXXXXoXoXoXoX
XoXoXoXoXXooXooXXoXXXXoXXXXoXoXoXoX
XoXoXoXoXXXoooXXXoXXXXoXXXXoXoXoXoX
XoXoXoXoXXXXoXXXXoXXXXoXXXXoXoXoXoX
XoooooXoooooooooooooooooooooXoooooX
XoXoXoXXXXXXXXXXXoXXXXXXXXXXXoXoXoX
XoXoXoooooooooooooooooooooooooXoXoX
XoXoXXXoXXXXoXXXXOXXXXoXXXXoXXXoXoX
XoXoooooooooooooooooooooooooooooXoX
XoXXXXXXXoXXXXXXXoXXXXXXXoXXXXXXXoX
XSoooooooooooooooooooooooooooooooSX
XXXXXXXXXXXXXXXXXXXXXXXXXXXXXXXXXXX