XXXXXXXXXXXXXXXXX
XSoooXXoPoXXoooSX
XoXXooooXooooXXoX
XooooXXoooXXooooX
XXXXXXXoXoXXXXXXX
XSoooooooooooooSX
XTXXXTXXXXXTXXXTX
XGXXXGXXXXXGXXXGX
XXXXXXXXXXXXXXXXX