XXXXXXXXXXXXXXXXXXXXXXXXXXXX
XooooooXXXX_GGGG_XXXXooooooX
XoXXoXoXXXXXXTXXXXXXXoXoXXoX
XoXXoXoXXooooooooooXXoXoXXoX
XoXXoXoXXoXXXXXXXXoXXoXoXXoX
XoXXoXoXXoXXXXXXXXoXXoXoXXoX
XooooooooooooXXooooooooooooX
XoXXXXoXXXXXoXXoXXXXXoXXXXoX
XoXXXXoXXXXXoXXoXXXXXoXXXXoX
XOooXXoooooooPPoooooooXXooOX
XXXoXXoXXoXXXXXXXXoXXoXXoXXX
XXXoXXoXXoXXXXXXXXoXXoXXoXXX
XooooooXXooooXXooooXXooooooX
XoXXXXXXXXXXoXXoXXXXXXXXXXoX
XoXXXXXXXXXXoXXoXXXXXXXXXXoX
XooooooooooooooooooooooooooX
XoXXXXXXXXXXXXXXXXXXXXXXXXoX
XoXXXXXXXXXXXXXXXXXXXXXXXXoX
XSooooooooooooooooooooooooSX
XoXXXXoXXXXXoXXoXXXXXoXXXXoX
XoXXXXoXXXXXoXXoXXXXXoXXXXoX
XoXXXXoXXXXXoXXoXXXXXoXXXXoX
XooooooooooooooooooooooooooX
XoXXXXoXXoXXXXXXXXoXXoXXXXoX
XoXXXXoXXoXXXXXXXXoXXoXXXXoX
XooooooXXooooXXooooXXooooooX
XXXXXXoXXXXXoXXoXXXXXoXXXXXX
XooooooooooooXXooooooooooooX
XoXXXXoXXXXXoXXoXXXXXoXXXXoX
XoXXXXoXXXXXoXXoXXXXXoXXXXoX
XOooXXoooooooPPoooooooXXooOX
XXXoXXoXXoXXXXXXXXoXXoXXoXXX
XXXoXXoXXoXXXXXXXXoXXoXXoXXX
XooooooXXooooXXooooXXooooooX
XoXXXXXXXXXXoXXoXXXXXXXXXXoX
XoXXXXXXXXXXoXXoXXXXXXXXXXoX
XSooooooooooooooooooooooooSX
XXXXXXXXXXXXXXXXXXXXXXXXXXXX