XXXXXXXXX
XEOOXOOEX
XOOOGOOOX
XOXXXXXOX
XFXXXXXFX
XOXXXXXOX
XEOOPOOEX
XXXXXXXXX