XXXXXXXXX
XOOOXOOOX
XOOOOOOOX
XOXXXXXOX
XOXXXXXOX
XOXXXXXOX
XOOOOOOOX
XXXXXXXXX