XXXXXXXXXX
XOOOOOOOOX
XOOOXOOOOX
XOXXXXXOOX
XOXXXXXOOX
XOXXXXXOOX
XOOOOOOOOX
XXXXXXXXXX