XXXXXXXXX
XOOOOOOOX
XOOOXOOOX
XOXXXXXOX
XOXXXXXOX
XOXXXXXOX
XOOOOOOOX
XXXXXXXXX