XXXXXXXXX
XOFOXOFOX
XOOOGOOOX
XOXXXXXOX
XFXXXXXFX
XOXXXXXOX
XOOOPOOOX
XXXXXXXXX