XXXXXXXXXXXXXXXXXXXXXXXXXXXX
XSoooooooooooXXoooooooooooSX
XoXXXXoXXXXXoXXoXXXXXoXXXXoX
XOXXXXoXXXXXoXXoXXXXXoXXXXOX
XoXXXXoXXXXXoXXoXXXXXoXXXXoX
XooooooooooooooooooooooooooX
XoXXXXoXXoXXXXXXXXoXXoXXXXoX
XoXXXXoXXoXXXXXXXXoXXoXXXXoX
XooooooXXooooXXooooXXooooooX
XXXXXXoXXXXX_XX_XXXXXoXXXXXX
XXXXXXoXXXXX_XX_XXXXXoXXXXXX
XXXXXXoXX__________XXoXXXXXX
XXXXXXoXX_XXXXXXXX_XXoXXXXXX
XXXXXXo___X_GGGG_X___oXXXXXX
XXXXXXoXX_XXXTTXXX_XXoXXXXXX
XXXXXXoXX__________XXoXXXXXX
XXXXXXoXX_XXXXXXXX_XXoXXXXXX
XXXXXXoXX_XXXXXXXX_XXoXXXXXX
XooooooooooooXXooooooooooooX
XoXXXXoXXXXXoXXoXXXXXoXXXXoX
XoXXXXoXXXXXoXXoXXXXXoXXXXoX
XOooXXoooooooPPoooooooXXooOX
XSooooooooooooooooooooooooSX
XXXXXXXXXXXXXXXXXXXXXXXXXXXX