XXXXXXXXXXXXXXXXXXXXXXXXXXXX
XOEOOGGGGGGOOPPOOOOOOOOOOOOX
XOXXXXXXXXXXXXXXXXXXXXXXXXOX
XOOOOOOOOOOOOOOOOOOOOOOOOOOX
XXXXXXXXXXXXXXXXXXXXXXXXXXXX